000000000000000000000000
000000000000000000000000
000000000000000000000000
000000000000000000000000
000000001111111004000000
000000001000031400000000
000000001000201400000000
000000001111111004000000
000000000000000000000000
000000000000000000000000
000000000000000000000000
000000000000000000000000
