000000000000000000000000
000000000000000000000000
000000000000000000000000
000000000044400000000000
000000001111111000000000
000000041400421400000000
000000041243041400000000
000000001111111000000000
000000000044400000000000
000000000000000000000000
000000000000000000000000
000000000000000000000000
